11111111111
111C00000011
1E0000000001
1000P0000001
111111111111
