11111111111111
11011C00000111
1E0101110001C1
100001P0000111
11111111111111
