111111111111
11000E111011
1000P000C011
111111111111
