11111111
100P00C1
1C0000E1
11111111
