111111111
1P0C00001
1111E0111
100C00001
111111111
