11111111
100P00C1
1E000001
11111111
