11111111111111
11011C00000111
1E0101110000C1
100000P0000111
11111111111111
