1111111
11011E1
11E1P11
110C111
1111111
