11111111
100E0001
100C0011
1CP00001
11111111
