11111111111111
11011C00000011
1E010111000001
100001P1000001
11111111111111
