1111111111111111111111111111111111
1E0000000000000C00000C000000000001
1010010100100000101001000000010101
1010010010101010001001000000010101
100000000C00C0000000000000000000C1
1111110000111111111111001111001111
1000000P00111111111111001111000011
100000000C111111111111C11111100111
1111110000000C000000000000C1111111
1111111111111111111111111111111111
