11111111
100P00C1
1C0000E1
10000001
11111111
