

1111111111111111111111111111111111
1E000000000000NC00000C0000000N0001
1010010100100000101001000000010101
1010010010101010001001000000010101
100000000C00C0000000000000N00000C1
1111110000111111111111001111001111
100P0000N0111111111111001111000011
100000000C111111111111C11111100111
1111110000000C000000000000C1111111
1111111111111111111111111111111111



